

NO                  ./path_to_the_north_texture

SO                          ./path_to_the_south_texture


WE          ./path_to_the_west_texture




EA ./path_to_the_east_texture

F 225,255,255




C 255,255,255



        1111111111111111111111111
        1001000000110000000000001
        1011000001110000001000001
        1001000000000000000000001
111111111011000001110000000000001
100000000011000001110111101111111
11110111111111011100000000001
11110111111111011101010010001
110000001101010111000001N1001
10001000000000001100000010001
10000000000000001101010000001
110000011101010111110111100111
11110111 1110101 101111010001
11111111 1111111 111111111111
